WWWWWWWWWWWWWWWWWWWWWWWWWWWW
WnddddndddddsWWsdddddnddddnW
WdWWWWdWWWWWdWWdWWWWWdWWWWdW
WDWWWWdWWWWWdWWdWWWWWdWWWWDW
WdWWWWdWWWWWdWWdWWWWWdWWWWdW
WnddddndddddnddndddddnddddnW
WdWWWWdWWdWWWWWWWWdWWdWWWWdW
WdWWWWdWWdWWWWWWWWdWWdWWWWdW
WsddddnWWnddnWWnddnWWnddddsW
WWWWWWdWWWWWeWWeWWWWWdWWWWWW
WWWWWWdWWWWWeWWeWWWWWdWWWWWW
WWWWWWdWWNeeNeeNeeNWWdWWWWWW
WWWWWWdWWeWWWggWWWeWWdWWWWWW
WWWWWWdWWeWeeeeeeWeWWdWWWWWW
eeeeeeneeSWeeeeeeWSeeneeeeee
WWWWWWdWWeWeeeeeeWeWWdWWWWWW
WWWWWWdWWeWWWWWWWWeWWdWWWWWW
WWWWWWnWWNeeeeeeeeNWWnWWWWWW
WWWWWWdWWeWWWWWWWWeWWdWWWWWW
WWWWWWdWWeWWWWWWWWeWWdWWWWWW
WnddddsddnddnWWnddnddsddddnW
WdWWWWdWWWWWdWWdWWWWWdWWWWdW
WDWWWWdWWWWWdWWdWWWWWdWWWWDW
WndnWWndddddnPPndddddnWWndnW
WWWdWWdWWdWWWWWWWWdWWdWWdWWW
WWWdWWdWWdWWWWWWWWdWWdWWdWWW
WsdnddnWWnddnWWnddnWWnddndsW
WdWWWWWWWWWWdWWdWWWWWWWWWWdW
WdWWWWWWWWWWdWWdWWWWWWWWWWdW
WnddddddddddsddsddddddddddnW
WWWWWWWWWWWWWWWWWWWWWWWWWWWW 