WWWWWWWWWWWWWWWWWWWWWWWWWWWW
WnddddndddddsWWsdddddnddddnW
WdWWWWdWWWWWdWWdWWWWWdWWWWdW
WDWWWWdWWWWWdWWdWWWWWdWWWWDW
WdWWWWdWWWWWdWWdWWWWWdWWWWdW
WnddddnddnddnddnddnddnddddnW
WdWWWWdWWdWWWWWWWWdWWdWWWWdW
WdWWWWdWWdWWWWWWWWdWWdWWWWdW
WsddddnWWnddnWWnddnWWnddddsW
WWWWWWdWWWWWeWWeWWWWWdWWWWWW
WWWWWWdWWWWWeWWeWWWWWdWWWWWW
WWWWWWdWWNeeNeeNeeNWWdWWWWWW
WWWWWWdWWeWWWWWWWWeWWdWWWWWW
WWWWWWdWWeWeeeeeeWeWWdWWWWWW
eeeeeeneeSWeeeeeeWSeeneeeeee
WWWWWWdWWeWeeeeeeWeWWdWWWWWW
WWWWWWdWWeWWWWWWWWeWWdWWWWWW
WWWWWWnWWNeeeeeeeeNWWdWWWWWW
WWWWWWdWWeWWWWWWWWeWWdWWWWWW
WWWWWWdWWeWWWWWWWWeWWdWWWWWW
WnddddsddnddnWWnddnddsddddnW
WdWWWWdWWWWWdWWdWWWWWdWWWWdW
WDWWWWdWWWWWdWWdWWWWWdWWWWDW
WndnWWndddddnPPnddnddnWWndnW
WWWdWWdWWdWWWWWWWWdWWdWWdWWW
WWWdWWdWWdWWWWWWWWdWWdWWdWWW
WsdnddnWWnddnWWnddnWWnddndsW
WdWWWWWWWWWWdWWdWWWWWWWWWWdW
WdWWWWWWWWWWdWWdWWWWWWWWWWdW
WnddddddddddsddsddddddddddnW
WWWWWWWWWWWWWWWWWWWWWWWWWWWW 