WWWWWWWWWWWWWWWWWWWWWWWWWWWW
WnddddndddddsWWsdddddnddddnW
WdWWWWdWWWWWdWWdWWWWWdWWWWdW
WDWWWWdWWWWWdWWdWWWWWdWWWWDW
WdWWWWdWWWWWdWWdWWWWWdWWWWdW
WnddddndddddnddndddddnddddnW
WdWWWWdWWdWWWWWWWWdWWdWWWWdW
WdWWWWdWWdWWWWWWWWdWWdWWWWdW
WsddddnWWnddnWWnddnWWnddddsW
WWWWWWdWWWWWdWWdWWWWWdWWWWWW
WWWWWWdWWWWWdWWdWWWWWdWWWWWW
WWWWWWdWWnddnddnddnWWdWWWWWW
WWWWWWdWWdWWWWWWWWdWWdWWWWWW
WWWWWWdWWdWeeeeeeWdWWdWWWWWW
eeeeeenddsWeeeeeeWsddneeeeee
WWWWWWdWWdWeeeeeeWdWWdWWWWWW
WWWWWWdWWdWWWWWWWWdWWdWWWWWW
WWWWWWnWWnddddddddnWWnWWWWWW
WWWWWWdWWdWWWWWWWWdWWdWWWWWW
WWWWWWdWWdWWWWWWWWdWWdWWWWWW
WnddddsddnddnWWnddnddsddddnW
WdWWWWdWWWWWdWWdWWWWWdWWWWdW
WDWWWWdWWWWWdWWdWWWWWdWWWWDW
WndnWWndddddnPPndddddnWWndnW
WWWdWWdWWdWWWWWWWWdWWdWWdWWW
WWWdWWdWWdWWWWWWWWdWWdWWdWWW
WsdnddnWWnddnWWnddnWWnddndsW
WdWWWWWWWWWWdWWdWWWWWWWWWWdW
WdWWWWWWWWWWdWWdWWWWWWWWWWdW
WnddddddddddsddsddddddddddnW
WWWWWWWWWWWWWWWWWWWWWWWWWWWW 